1111111111111
1P000E000X0C1
1111111111111