1111111111111111111111111111111111
1E00000000000C000C0000000000000001
10100101001000101000000100000C0101
1010010010101010100100000000000101
1P0000000C00C000000CC01000000000C1
1111111111111111111111111111111111