1111111111111111111111111
1P010000000C0001110X01001
1000011111000100X00110001
1100101E000100X0111001X01
10X010001000000000C000001
1000110110111000111110X01
100000X00C000101001C10101
100011000000100100000C001
1011000111010010011110001
10000000000101C1000011001
1010X01111000X00X0C000101
100100C00000111001110C001
1111111111111111111111111