111111
101XE1
1PC001
10X001
111111