111111
1010E1
1PC0X1
10X001
111111