1111111111111
1P000E00000C1
1111111111111