111111
1010E1
1PC001
100001
111111