1111111111111111111111111111111111111
10010000000C0000000000000000000000001
1000011111000000000000000000000000001
1P00101E00000000000000000000000000001
1111111111111111111111111111111111111