1111111111111111111111111
1P010000000C0001110001001
1000011111000100000110001
1100101E00010000111001001
100010001000000000C000001
1000110110111000111110001
100000000C000101001C10101
100011000000100100000C001
1011000111010010011110001
10000000000101C1000011001
101000111100000000C000101
100100C00000111001110C001
1111111111111111111111111