111111
1010E1
1P0001
100001
111111