111111
101001
1PC001
100001
111111