111111
1010E1
10C001
100001
111111