111111
1010E1
1PC0001
100001
111111