111111
1010E1
1PC000
100001
111111