111111
1010E1
1PC001
100u01
111111